users,thread,thread_internal,thread_external,contribution,contribution_internal,contribution_external
mitsudome-r,41,7,11,112,9,103
maxime-clem,16,2,13,101,14,87
xczhanjun,2,0,2,3,0,3
isamu-takagi,7,3,7,26,3,23
g-ise,1,0,0,2,0,2
BonoloAWF,54,5,31,11,0,11
Unknown,40,5,20,30,7,23
Igata-ctrl,80,0,3,6,2,4
xmfcx,35,4,22,83,7,76
LLplane,1,0,1,1,0,1
h-ohta,1,0,1,0,0,0
meliketanrikulu,12,3,11,15,3,12
jason914,3,1,3,3,0,3
WJaworskiRobotec,27,1,2,4,0,4
goktugyildirim,1,0,0,0,0,0
JokerWhy233,1,1,1,0,0,0
JohannesBetz,3,0,0,0,0,0
ambroise-arm,2,0,2,8,0,8
HaoruXue,5,1,2,3,0,3
shmpwk,11,1,11,43,7,36
PengfeiLin0609,1,0,1,1,0,1
soblin,6,3,6,3,0,3
sevocrear,1,0,1,1,0,1
IshitaTakeshi,12,3,10,7,1,6
esteve,2,0,2,13,1,12
kminoda,24,4,20,56,5,51
scepter914,2,1,2,4,2,2
Denri006,2,0,2,2,0,2
armaganarsln,26,1,4,12,3,9
Sharrrrk,4,1,4,15,2,13
crazydude123,1,1,1,1,0,1
storrrrrrrrm,3,2,3,6,2,4
takayuki5168,4,1,3,55,7,48
Mud-B,1,0,1,1,0,1
ajay1606,2,1,2,3,0,3
amtommy,2,1,2,2,1,1
mojomex,2,0,2,1,0,1
brkay54,9,2,8,19,0,19
kenji-miyake,2,0,2,98,11,87
sglee-morai,9,0,1,3,1,2
chris-interplai,2,0,2,1,0,1
waynejstaats,1,0,0,0,0,0
brian841102,6,2,6,6,1,5
08beeqtufail-sudo,1,0,1,1,0,1
anushamandalapu-tomtom,1,0,1,1,0,1
RyuYamamoto,2,0,2,3,0,3
samehmohamed88,1,1,1,2,2,0
raminterpl,2,1,2,4,1,3
FabioSpano,1,1,0,0,0,0
HamburgDave,30,0,7,4,0,4
VRichardJP,21,2,14,32,4,28
mimimidododo,1,1,1,1,0,1
NorahXiong,4,0,4,5,0,5
angry-crab,3,1,3,15,2,13
mertyavuz41,3,0,3,4,0,4
YamatoAndo,2,1,2,23,5,18
takam5f2,1,0,0,3,0,3
hatem-darweesh,3,0,3,9,1,8
plane-li,1,0,1,3,0,3
koraykoca,3,0,2,2,0,2
CagriCatik,1,0,1,3,0,3
mehmetdogru,14,3,14,23,5,18
TomoyukiaW,1,0,1,1,0,1
andrejpadilha2,1,0,0,1,0,1
doganulus,2,0,0,16,3,13
alanmengg,1,0,0,0,0,0
Zeysthingz,2,0,2,4,0,4
bariskapaligoz,1,0,1,1,0,1
QZJGeorge,10,1,3,1,1,0
kielczykowski-rai,1,1,0,0,0,0
MichaelShen97,1,1,0,0,0,0
QipiaoZhou,1,0,1,0,0,0
jihwankimqd,1,1,1,1,0,1
JordanCrawfordx,2,1,2,1,0,1
deansaco,1,0,1,1,0,1
tecena,1,0,0,0,0,0
MrOCW,34,7,30,16,2,14
Kei-OO,1,0,0,0,0,0
EcotronCorp,11,2,5,0,0,0
knzo25,1,0,1,1,1,0
nabetetsu,2,1,1,2,1,1
NilaySener,1,0,1,1,0,1
gayar-helm,1,0,1,2,0,2
twbabyduck,2,0,2,2,0,2
SyahirMuzni,3,0,1,0,0,0
kasper-helm,4,2,3,2,1,1
Light7Rain,1,0,0,0,0,0
youxiho1,2,0,2,1,0,1
kaspermeck-arm,10,3,10,21,3,18
Gian-Alessio,1,1,0,0,0,0
lijiaming5550,1,0,0,0,0,0
HuaweiAlgolux,3,0,3,6,0,6
kaola0504,1,0,0,0,0,0
takeshi-iwanari,2,0,1,2,1,1
Croquembouche,4,2,3,5,1,4
kenichirohatayama,1,1,1,1,0,1
tninja1,1,0,1,0,0,0
jiangguoding,1,0,1,1,0,1
shulanbushangshu,7,2,5,4,1,3
sisaha9,4,0,4,5,0,5
lhakim85,5,2,5,16,3,13
tkm2261,1,0,1,1,0,1
urbansound8K,1,0,0,0,0,0
Torreskai0722,1,0,1,0,0,0
bdcong,2,0,1,1,0,1
fightingnoble,1,0,1,1,0,1
ralwing,1,0,1,6,0,6
lilyrosecarnation,1,0,1,0,0,0
AminoACID123,1,0,1,0,0,0
akorb,2,0,1,2,0,2
gaokao123,4,1,2,3,0,3
osholsonel20,4,2,3,2,1,1
evshary,8,0,6,35,3,32
pjj707278870,2,1,2,0,0,0
enesadastec,3,1,2,2,1,1
Minsu-Kim-KNU,1,0,0,0,0,0
RalphGarson,1,0,1,1,0,1
Mingyu1991,3,0,2,2,0,2
Hyeongseok-Jeon,5,0,0,2,0,2
StepTurtle,6,2,5,5,0,5
hayato-m126,1,0,0,0,0,0
timecrisis5,1,0,0,0,0,0
jfqureshi,1,0,0,0,0,0
rsasaki0109,2,0,2,20,2,18
sfukuta,1,0,1,1,0,1
tleyden,6,1,4,6,1,5
gurselturkeri,7,1,7,5,1,4
ln879044,1,0,0,0,0,0
yukkysaito,8,1,6,59,6,53
kosuke55,2,2,2,16,2,14
ydcttt,1,1,1,0,0,0
sethut1224,1,0,1,0,0,0
PaGu3,1,0,1,2,0,2
tzu-lin-huang-128,1,0,1,0,0,0
cyn-liu,9,0,4,6,0,6
lionator,1,0,0,1,0,1
satoshi-ota,2,0,2,22,5,17
n-patiphon,18,0,3,11,0,11
nainaigetuide,3,1,1,3,0,3
purewater0901,1,0,1,2,0,2
anilbommareddy,5,2,4,4,1,3
malayjerdi,1,0,1,1,0,1
phoenares,2,0,2,1,0,1
g2181053,1,1,1,0,0,0
MarioAlmelaUMH,7,2,7,7,2,5
TZECHIN6,2,0,2,7,0,7
marcusvinicius178,3,1,3,3,0,3
arjunshetty955,2,1,1,2,0,2
ismetatabay,1,0,1,3,1,2
ashkildighin,1,0,0,2,1,1
Ryujiyasu,2,0,2,2,0,2
msanchezvicom,1,0,0,1,1,0
nbehrnbehr,2,0,1,1,0,1
miku54,1,0,0,0,0,0
xia-ya,1,0,0,0,0,0
cjffly,7,2,7,4,1,3
tongyucong,1,0,1,1,0,1
Youneko,1,0,1,1,0,1
donnieliu,2,0,2,2,0,2
patelabhay-12,3,0,2,1,0,1
wangxianggang1997,11,1,10,4,1,3
LiangHuangBC,1,0,1,1,0,1
mariosebasco,1,1,1,1,1,0
HyunkiKim0407,1,0,0,1,0,1
kohei-y1123,1,0,0,0,0,0
pwrcoder1391,1,0,0,0,0,0
KhalilSelyan,3,0,3,2,0,2
nicolasdec,1,0,1,0,0,0
adnanhaf,4,0,3,1,0,1
JianKangEgon,4,1,2,1,0,1
batuhanbeytekin,1,0,1,0,0,0
lianbin,1,1,0,0,0,0
Robotics010,4,1,3,4,0,4
joewong00,2,0,1,1,0,1
AndriiChumak145,2,0,2,2,0,2
HamedMesri-TomTom,1,0,1,1,0,1
peaky-quest,1,0,1,0,0,0
kaancolak,1,1,1,7,1,6
mshah72,3,1,3,2,0,2
,3,0,0,0,0,0
lchojnack,1,0,1,0,0,0
ahmeddesokyebrahim,5,2,4,10,1,9
yvzksgl,1,0,1,2,0,2
leeseho,1,0,1,1,0,1
saicsk-deloitte,3,1,2,2,1,1
pradhanshrijal,1,0,1,1,0,1
pukachupenn,1,0,1,1,0,1
Hensbag,13,1,11,7,0,7
YusufDALAK,3,1,3,3,0,3
nitro6206,2,0,2,2,0,2
AviBen96,1,0,1,2,0,2
sykwer,1,1,1,2,0,2
joseph16388,2,2,0,0,0,0
izzetbasli,1,0,1,1,0,1
wutianze,1,0,1,1,0,1
jbyang1,1,1,1,1,0,1
jediofgever,1,0,1,1,0,1
damodarRohit,7,4,6,11,3,8
benrbray,1,1,1,1,1,0
HMX2013,1,0,0,0,0,0
beyzanurkaya,3,1,3,2,1,1
albiim,1,0,1,2,0,2
Kim-mins,5,2,5,6,1,5
yangjiameng,1,0,1,0,0,0
Nick79919030,1,1,1,1,1,0
zhuyingxiang95,4,1,2,3,0,3
zillur-av,20,2,19,20,0,20
Bistuwwh,1,0,1,0,0,0
Narendarselva,2,0,0,0,0,0
mayacarla2070,1,0,1,2,1,1
yaoweixiao-ux,2,0,0,0,0,0
beginningfan,8,2,5,8,2,6
ryanyej,1,0,1,0,0,0
sudhsrik,1,1,1,2,1,1
Tester2009,2,1,1,2,1,1
ddutan2000,1,0,0,0,0,0
davutcanakbas,2,1,2,2,1,1
asa-naki,4,0,3,2,0,2
SakodaShintaro,6,0,5,6,0,6
LIIHWF,1,1,1,1,0,1
screenflip,2,1,1,1,0,1
drwnz,14,2,3,6,0,6
Naophis,2,0,2,2,0,2
justin-ucdavis,1,0,1,0,0,0
goomy241,1,1,1,1,0,1
gauthamnarayan,1,1,1,1,0,1
logihp,1,0,1,1,0,1
lexavtanke,2,0,0,3,0,3
zymgp,1,0,1,1,0,1
vnodpangul,1,0,1,0,0,0
jamestkpoon,1,0,0,0,0,0
KYabuuchi,3,0,3,15,1,14
oosuiw,1,0,0,0,0,0
TakaHoribe,5,0,3,39,2,37
RAAA-Alaguvel-Armstrong,1,0,1,0,0,0
TaikiYamada4,3,0,3,3,0,3
shintaro-mori,3,0,3,3,0,3
chishengshih,17,2,8,14,2,12
porizou,2,0,2,1,0,1
kshitiz-deloitte,1,0,1,1,0,1
LGerstla01,1,0,1,1,0,1
major2012ye,2,0,2,4,0,4
L-Net-1992,2,0,2,2,0,2
Autostone-c,11,1,5,15,2,13
hcn1519,1,0,1,1,0,1
JoonKi0111,3,1,3,0,0,0
SKT-r,1,0,0,0,0,0
prabanjanGITHUB,4,2,2,2,0,2
yuasabe,10,1,5,10,0,10
Tanishq30052002,2,0,2,6,1,5
JulioPlaced,1,0,0,0,0,0
yaukaizhi,4,0,3,2,0,2
zeidk,1,0,1,2,0,2
lishizhen1412,1,1,1,1,0,1
museas-azm,1,1,1,1,0,1
sarubito,1,0,1,1,0,1
inwoong32,2,1,2,2,1,1
egkim-kitech,1,0,0,0,0,0
DaikiNiimi,1,0,1,1,0,1
yoneyoneclub,1,0,1,0,0,0
J-xinyu,6,1,4,9,1,8
pojenwang,9,0,2,0,0,0
felixf4xu,9,1,6,7,2,5
polurik,1,0,1,1,0,1
tomaszkapron,1,0,1,1,0,1
oguzkaganozt,12,0,1,3,1,2
davidc0619,2,0,2,1,0,1
mosss-code,1,1,1,1,0,1
fiwz789,2,0,1,1,0,1
liangzhiqiang-lzq,1,0,0,0,0,0
ataparlar,1,0,0,1,0,1
AhmadAmine998,1,0,1,0,0,0
MlLearnerAkash,1,0,0,0,0,0
hoppss,1,1,1,1,1,0
radolin,2,0,1,0,0,0
lixianqiang,2,0,1,1,0,1
AElkenawy,1,0,1,1,0,1
xoofee,1,1,1,1,0,1
Kaipa-Charan,2,0,2,3,0,3
pflee2002,1,0,1,0,0,0
dilloncsr,1,0,1,2,0,2
hdossaji94,2,1,2,2,0,2
plainspoken-chris,1,0,1,1,0,1
yama42326,1,0,1,1,0,1
pandyah,1,0,1,0,0,0
hzkkk1997,6,0,4,7,1,6
hakanaktass,3,0,2,2,0,2
zzx568730371,1,0,1,0,0,0
Rumika685,1,0,0,0,0,0
MechanoPixel,1,1,1,1,0,1
okataka123,3,0,2,3,1,2
phoenixGG,1,0,0,0,0,0
yuntianyi-chen,2,1,2,4,1,3
lawbreaker2022,1,0,1,0,0,0
TAICHInoda,1,0,1,1,0,1
muratgozum45,4,0,4,4,0,4
norikenpi,2,0,2,2,0,2
whbcumtb,1,0,1,14,1,13
lorenzzhao,1,0,1,1,0,1
TobiasMascetta,1,0,1,1,0,1
eromreve123,1,0,1,1,0,1
dotun457,1,0,1,1,0,1
ziri4k,3,0,3,2,0,2
hliu869,2,0,2,2,0,2
mkakh,1,0,1,1,0,1
dong-hub-png,1,0,0,0,0,0
tianhuangshi,1,0,0,0,0,0
letsgoniaoniao,1,0,0,1,0,1
adi-driveu,1,1,1,1,1,0
WyjFrogi,1,0,0,0,0,0
yuanchao16,2,0,2,2,0,2
doyan00,1,0,1,1,0,1
aez99,1,0,0,0,0,0
IDS-zhangxr,1,0,1,1,0,1
danicannt,4,1,3,3,0,3
YashuMessi18,1,0,1,0,0,0
KASUYASU,1,0,1,2,0,2
wifo130,1,1,0,0,0,0
boyang9602,4,1,1,0,0,0
asana17,1,0,0,0,0,0
chavankunal,1,0,1,0,0,0
stefanofio,1,0,1,0,0,0
LouiMilvus,2,0,0,0,0,0
jieunko,1,0,0,0,0,0
klausmikealsontheking,1,1,0,0,0,0
tseco15,1,0,1,2,0,2
chivas1000,1,0,1,1,0,1
npnquang,1,1,1,1,0,1
badai-nguyen,1,0,0,9,3,6
danielsanchezaran,1,0,1,1,0,1
alexandrx,0,0,0,1,1,0
taikitanaka3,0,0,0,8,2,6
JWhitleyWork,0,0,0,3,1,2
boyali,0,0,0,1,0,1
hueirutseng,0,0,0,11,2,9
NaoyoriTanzawa,0,0,0,1,0,1
piotr-zyskowski-rai,0,0,0,2,0,2
aohsato,0,0,0,9,1,8
kei-t4,0,0,0,1,0,1
afaerber,0,0,0,1,1,0
LucaFos,0,0,0,1,0,1
YoshinoriTsutake,0,0,0,3,0,3
emi0116,0,0,0,1,0,1
yabuta,0,0,0,1,0,1
rej55,0,0,0,2,0,2
mschratter,0,0,0,1,0,1
FranzAlbers,0,0,0,1,0,1
cycyc1949,0,0,0,6,0,6
hect95,0,0,0,1,0,1
yukke42,0,0,0,9,1,8
lntsh854,0,0,0,2,0,2
JessicaTegner,0,0,0,1,0,1
HiroIshida,0,0,0,1,1,0
Danior2235,0,0,0,1,1,0
miursh,0,0,0,13,0,13
kfunaoka,0,0,0,1,0,1
zulfaqar-azmi-t4,0,0,0,17,1,16
JToolGD,0,0,0,1,0,1
phkarle,0,0,0,2,0,2
MertClk,0,0,0,10,0,10
sayondeep,0,0,0,3,0,3
wep21,0,0,0,3,0,3
hasanzfdn,0,0,0,1,0,1
greensky0802,0,0,0,2,0,2
YueChuCheng,0,0,0,1,0,1
paolacanuto,0,0,0,1,0,1
simon-t4,0,0,0,1,0,1
Shin-kyoto,0,0,0,9,0,9
liuypcoding,0,0,0,2,0,2
lsteinosk,0,0,0,2,0,2
ashishrrs,0,0,0,1,0,1
HarryMechatron,0,0,0,1,0,1
domajstorovic,0,0,0,1,0,1
tkhmy,0,0,0,1,0,1
manato,0,0,0,1,0,1
Madhuvd,0,0,0,1,0,1
djargot,0,0,0,1,0,1
cyhunblr,0,0,0,1,0,1
liuXinGangChina,0,0,0,20,3,17
urayuto,0,0,0,1,1,0
HansRobo,0,0,0,6,0,6
mackierx111,0,0,0,4,0,4
rolandvanvenrooy-tomtom,0,0,0,1,0,1
harihitode,0,0,0,1,1,0
guankou,0,0,0,1,0,1
caiyuexiang,0,0,0,1,0,1
mertbacaksiz,0,0,0,1,0,1
fengziHK,0,0,0,1,0,1
Tom-Li-Lee,0,0,0,1,0,1
sezan92,0,0,0,1,0,1
fadimecetiner,0,0,0,2,0,2
samet-kutuk,0,0,0,1,0,1
mgarnett21,0,0,0,2,1,1
ktro2828,0,0,0,5,0,5
jacksilb,0,0,0,1,0,1
amadeuszsz,0,0,0,2,0,2
villaoningfootball,0,0,0,2,0,2
liuzf1988,0,0,0,1,0,1
JonasHablitzel,0,0,0,1,0,1
sahapratik5656,0,0,0,1,1,0
ahuazuipiaoliang,0,0,0,1,1,0
kyoichi-sugahara,0,0,0,4,0,4
wbq0206,0,0,0,8,0,8
markusschratter,0,0,0,1,0,1
RamanaBotta,0,0,0,1,0,1
BritvaBo,0,0,0,1,0,1
pedrorito,0,0,0,1,0,1
kedarnadh-123,0,0,0,1,0,1
RogerJung,0,0,0,1,0,1
Levinskis,0,0,0,1,0,1
hakuturu583,0,0,0,2,0,2
gdengchao,0,0,0,1,0,1
YoshiRi,0,0,0,1,0,1
amc-nu,0,0,0,2,1,1
TUMGEKA,0,0,0,1,0,1
isouf,0,0,0,1,0,1
jerry73204,0,0,0,1,0,1
idorobotics,0,0,0,4,0,4
buraakozcan,0,0,0,1,0,1
jp-amaral,0,0,0,1,0,1
dylan-gonzalez,0,0,0,1,1,0
